1111111111111
10000000000E1
1000000000001
10P0000000001
1111111111111
