11111111111111111111111
10000000000000000010001
1000P000000000000000001
10001000000000000000001
100010000000000000C0001
10001000000010000000001
1000000000001E000000001
10000000000011100000001
10010000000000000C00001
10010000000000000000001
1C010000000000000CCC111
11111111111111111111111
